SW,SW,SW,SW,SW,SW,SW,SW,SW,SW,SW,SW,SW,SW,SW,SW,SW
SW,G,G,G,G,G,G,G,G,G,G,G,G,G,G,G,SW
SW,G,G,G,G,G,G,G,G,G,G,G,G,G,G,G,SW
SW,G,G,G,G,D,D,D,D,G,G,G,G,G,G,G,SW
SW,G,G,G,G,D,G,G,G,G,G,G,G,G,G,G,SW
SW,G,G,G,G,D,G,G,G,G,G,G,G,G,G,G,SW
SW,G,G,G,D,D,G,G,G,G,G,G,G,G,G,G,SW
SW,G,G,G,G,G,G,G,G,G,G,G,G,G,G,G,SW
SW,G,G,G,G,G,G,G,G,G,G,G,G,G,G,G,SW
SW,SW,SW,SW,SW,SW,SW,SW,SW,SW,SW,SW,SW,SW,SW,SW,SW
