------------
|          |
|       R  |
|          |
|          |
|    P     |
|          |
|          |
|          |
|       F  |
|          |
------------
