S,S,S,S,S,S,S,S,S,S,S,S,S,S,S,S,S,S
S,S,S,S,S,S,S,S,S,S,S,S,S,S,S,S,S,S
S,S,S,S,S,S,S,S,S,S,S,S,S,S,S,S,S,S
S,S,S,S,S,S,S,S,S,S,S,S,S,S,S,S,S,S
S,S,S,S,S,S,S,G,G,G,G,G,G,S,S,S,S,S
S,S,S,S,S,S,S,G,G,G,G,G,G,S,S,S,S,S
S,S,S,S,S,S,S,G,G,D,D,G,G,S,SS,S,S,S
S,S,S,S,S,S,S,G,G,D,D,G,G,S,S,S,S,S
S,S,S,S,S,S,S,G,G,G,G,G,G,S,S,S,S,S
S,S,S,S,S,S,S,G,G,G,G,G,G,S,S,S,S,S
