SW,SW,SW,SW,SW,SW,SW,SW,SW,SW,SW,SW,SW,SW,SW,SW,SW
SW,G,G,G,G,G,G,G,G,G,G,G,G,G,G,G,SW
SW,G,G,G,G,G,G,G,D,G,D,G,G,D,G,G,SW
SW,G,G,G,G,G,G,D,G,G,D,D,G,D,G,G,SW
SW,G,G,G,D,G,D,G,D,D,G,G,G,G,G,G,SW
SW,G,D,D,D,D,D,G,D,G,D,G,D,D,G,G,SW
SW,G,G,D,D,D,D,D,D,G,D,D,G,D,G,G,SW
SW,G,D,D,D,D,D,D,D,D,G,D,D,D,G,G,SW
SW,G,G,G,G,G,G,G,G,G,G,G,G,G,G,G,SW
SW,SW,SW,SW,SW,SW,SW,SW,SW,SW,SW,SW,SW,SW,SW,SW,SW
