---------------
|         W    |
|       B W    |
| B       W    |
|         W    |
|    P    F    |
|        F     |
|         W    |
|F W      W    |
|  W    F W    |
|  W      W    |
---------------
