------------
|          |
|          |
|  P  B B  |
------------
